***************
***************
***######******
********#******
****S***#******
********#***D**
********#******
********#******
********#******
*****####******
***************
***************
***************
***************
***************
