***************
***************
***######******
*******##******
****S**##******
*******##***D**
*******//******
*******##******
*******##******
*****####******
***************
***************
***************
***************
***************
