***************
***************
***************
*******##******
*******##******
*******##******
*****S*##******
*******##***D**
*******//******
***************
***************
***************
***************
***************
***************
